3
3 3
4 3
5 3
RIGHT
3 3 3 3 3 3 3 3 3 3 3 3 3 3 3 3 3 3 3 3
3 0 0 0 0 0 0 0 3 3 3 3 0 0 0 0 0 0 0 3
3 0 0 0 0 0 0 0 3 3 3 3 0 0 0 0 0 0 0 3
3 0 0 0 0 0 0 0 3 3 3 3 0 0 0 0 0 0 0 3
3 0 0 0 0 0 0 0 3 3 3 3 0 0 0 0 0 0 0 3
3 0 0 0 0 0 0 0 3 3 3 3 0 0 0 0 0 0 0 3
3 0 0 0 0 0 0 0 3 3 3 3 0 0 0 0 0 0 0 3
3 0 0 0 0 0 0 0 3 3 3 3 0 0 0 0 0 0 0 3
3 0 0 0 0 0 0 0 3 3 3 3 0 0 0 0 0 0 0 3
3 0 0 0 0 0 0 0 3 3 3 3 0 0 0 0 0 0 0 3
3 0 0 0 0 0 0 0 0 0 0 0 0 0 0 0 0 0 0 3
3 0 0 0 0 0 0 0 0 0 0 0 0 0 0 0 0 0 0 3
3 0 0 0 0 0 0 0 0 0 0 0 0 0 0 0 0 0 0 3
3 0 0 0 0 0 0 0 0 0 0 0 0 0 0 0 0 0 0 3
3 0 0 0 0 0 0 0 0 0 0 0 0 0 0 0 0 0 0 3
3 0 0 0 0 0 0 0 0 0 0 0 0 0 0 0 0 0 0 3
3 0 0 0 0 0 0 0 0 0 0 0 0 0 0 0 0 0 0 3
3 0 0 0 0 0 0 0 0 0 0 0 0 0 0 0 0 0 0 3
3 0 0 0 0 0 0 0 0 0 0 0 0 0 0 0 0 0 0 3
3 3 3 3 3 3 3 3 3 3 3 3 3 3 3 3 3 3 3 3