3
3 3
4 3
5 3
RIGHT
4
2 40
4 15
5 25
7 20
3 3 3 3 3 3 3 3 3 3 3 3 3 3 3 3 3 3 3 3
3 0 0 0 0 0 0 0 3 3 3 3 0 0 0 0 0 0 0 3
3 0 0 0 0 0 0 0 3 3 3 3 0 0 0 0 0 0 0 3
3 0 0 0 0 0 0 0 3 3 3 3 0 0 0 0 0 0 0 3
3 0 0 0 0 0 0 0 3 3 3 3 0 0 0 0 0 0 0 3
3 0 0 0 0 0 0 0 3 3 3 3 0 0 0 0 0 0 0 3
3 0 0 0 0 0 0 0 3 3 3 3 0 0 0 0 0 0 0 3
3 0 0 0 0 0 0 0 3 3 3 3 0 0 0 0 0 0 0 3
3 0 0 0 0 0 0 0 3 3 3 3 0 0 0 0 0 0 0 3
3 0 0 0 0 0 0 0 3 3 3 3 0 0 0 0 0 0 0 3
3 0 0 0 0 0 0 0 0 0 0 0 0 0 0 0 0 0 0 3
3 0 0 0 0 0 0 0 0 0 0 0 0 0 0 0 0 0 0 3
3 0 0 0 0 0 0 0 0 0 0 0 0 0 0 0 0 0 0 3
3 0 0 0 0 0 0 0 0 0 0 0 0 0 0 0 0 0 0 3
3 0 0 0 0 0 0 0 0 0 0 0 0 0 0 0 0 0 0 3
3 0 0 0 0 0 0 0 0 0 0 0 0 0 0 0 0 0 0 3
3 0 0 0 0 0 0 0 0 0 0 0 0 0 0 0 0 0 0 3
3 0 0 0 0 0 0 0 0 0 0 0 0 0 0 0 0 0 0 3
3 0 0 0 0 0 0 0 0 0 0 0 0 0 0 0 0 0 0 3
3 3 3 3 3 3 3 3 3 3 3 3 3 3 3 3 3 3 3 3